%%%%%%%%%%%%%%%%%%%%%%%%%%%%%%
%.                          .%
%                            %
%                            %
%                            %
%                            %
%                            %
%                            %
%                            %
%                            %
%                            %
%                            %
%.   P                      .%
%%%%%%%%%%%%%%%%%%%%%%%%%%%%%%